                    NO ./img/c1.png
            SO ./img/floor1.png  











                                    WE ./img/p1.png
EA ./img/Waffles.pn                                         







F 220,43,10
C 225,30,0


11111111
100001001                      1111
1000011101                    10101
1111111 1                      101
                              10101
                               111

11111111               1
11110N1011
10001011101
1001100011
111111111                