 


 
 
                    NO ./img/c1.png
            SO ./img/c1.png  









                                    
EA ./img/p1.png                                 






F                               200,043,100
F 225,30,0 
WE                              ./img/p1.png



111111
100101
111111

111111
1000N1
111111

