 

                                                                        F200,043,100
 
 
                    NO ./img/c1.png
            SO ./img/e1.png  









                                    
EA./img/p1.png                                 





                             C 225,30,0                                            
WE                              ./img/p1.png



111111
100101
111111

111111
1000N1
111111

