                    NO ./img/c1.png
            SO ./img/floor1.png  











                                    WE ./img/p1.png
EA ./img/Waffles.png                                         







F 0000,43,0
C 225,30,0


11111111
1000010011
1000011101                      1
1111111 11                     101
                                1

11111111               1
11110N1011
10001011101
1001100011
111111111                