                    NO ./img/c2.png
            SO ./img/e2.png  











                                    WE ./img/p1.png
EA ./img/HD.png                                         







F 220,0,0
C 0,230,0


111111111
100000001
100D00101                    1
100D00011                   101                          
100D00001                    1
100D00001               1
100D0N1011
10001011101
1001100011
111111111                