                    NO ./img/c1.png
            SO ./img/e1.png  











                                    WE ./img/p1.png
EA ./img/Waffles.png                                         







F 220,43,0
C 225,30,0


11111111
100001001
1000011101                    1
100000111                    101                          1
100000001                     1
11111111               1
11110N1011
10001011101
1001100011
111111111                