                    NO ./img/c2.png
            SO ./img/e2.png  











                                    WE ./img/p1.png
EA ./img/Waffles.png                                         







F 220,0,0
C 0,230,0


11111111
100000001
1000000101                    1
100000011                    101                          1
100000001                     1
100000001               1
10000N1011
10001011101
1001100011
111111111                