                    NO ./img/c1.png
            SO ./img/e1.png  











                                    WE ./img/p1.png
EA ./img/Waffles.png                                         







F 220,43,0
C 225,30,0


11111111             
100001001
1000011101                      1
1111111 1                      101       
                                1

111111111              1                                                                                                    
10N0101101
1001100011
111111111
