                    NO ./img/test/w1.png
            SO ./img/test/w3.png  











                                    WE ./img/test/w4.png
EA ./img/test/w2.png                                         







F 220,0,0
C 0,230,0


1111111111
10000000001
100D0001001                     1
100D00000011                   101                          
100D000011                      1
100D00001               1
100D0N1011
10001011101
10011D0011
111111111                