                    NO ./path_to_the_north_texture                          
            SO ./path_to_the_south_texture  











                                    WE ./path_to_the_west_texture
EA ./path_to_the_east_texture                                         







F 220,100,0
C 225,30,0


111111
100001  1
1000011101                      1
1111111 1                      101
                                1

11111111               1
11110N1011
10001011101
1001100011
111111111                